####################
#*-------##-------*#
#-##--##----##--##-#
#--------##--------#
#-##-#-######-#-##-#
#----#---##---#----#
##-#-###-##-###-#-##
#--#------------#--#
#-##-#-##--##-#-##-#
#----#-#----#-#----#
#-##-#-######-#-##-#
#--#-#--------#-#--#
##-#-#-######-#-#-##
#------------------#
#--#-###-##-###-#--#
##-#-----##-----#-##
#----#--####--#----#
#-##-##--##--##-##-#
#*----------------*#
####################
