####################

#*----------------*#

#-#####--##--#####-#

#------------------#

#-#-#--######--#-#-#

#------------------#

#-#####--##--#####-#

#------------------#

#-#-#--##--##--#-#-#

#-#-#--#----#--#-#-#

#-#-#--######--#-#-#

#-#-#----------#-#-#

#------------------#

#-#####--##--#####-#

#------------------#

#-#-#--######--#-#-#

#------------------#

#-#####--##--#####-#

#*----------------*#
####################


